111111111111111111111111111111111111111111111
1E0000000000000C00000C0000000100101C0000C0011
1010010100100000101001000000010101010C0001011
101001001010101000100100000001010000000000011
1P0000000C00C0000000000000000000C110010001011
111111111111111111111111111111111111111111111