1111111111111111111111111111111111111111111111111111111111111111111111111111111111111111111111111111111111111111111111111111111111111111
1E00000V0000000C0V000C000000000001101001010010000010100100000001010110100101001000001010010000000101011010010100100000101001000000010101
10100101001000001010V0100000001010110100101001000001010010000000101011010010100100000101001000000010101101001010010000010100100000001001
1010010010101010001001000000010101101001010010000010100100000001010110100101001000001010010000000101011010010100100000101001000000010101
1P0000000C00C00000V00000000000000C110100101001000001010010000000101011010010100100000101001000000010101101001010010000010100100000001011
1111111111111111111111111111111111111111111111111111111111111111111111111111111111111111111111111111111111111111111111111111111111111111