1111111111111111111111111111111111
1E00000000V0000C00000C000000000001
101001010010000010100100V000010101
1010V10010101010001001000000010101
1P0000000C00C0000000000000V00000C1
1111111111111111111111111111111111